3.1
|------------------|
|O                E|
|O|--|-|-|  | |-|--|
|O    O|-|  | |    |
|O  O| |-|  | |  | |
|OOOO|O    O|    |-|
|----|-----------|O|
|O     |---------| |
|-|-   |     |     |
|   O|         |---|
| |----| |-|-- |---|
| |    |O |        |
|*|    |     O|  |O|
|------------------|


